####################
#                  #
# ##################
# ##################
#                  #
############# ######
############# ######
#                  #
# ###### ###########
# #                #
# ###### ###########
######## ###########
#                 ##
# ########### ######
#        #### ######
# ########### ######
# ##                
#### ###############
#                  #
####################